NO ./res/img/wall_0.xpm
SO ./res/img/wall_1.xpm
WE ./res/img/wall_2.xpm
EA ./res/img/wall_3.xpm

F 25,25,25
C 0,0,20

11111111111111
11000000000001
10000000000101
10000000000001
10000000000001
10000000000001
10000000000001
10N00000000001
10000000000001
11111111111111

