NO ./res/img/wall_0.xpm
SO ./res/img/wall_1.xpm
WE ./res/img/wall_2.xpm
EA ./res/img/wall_3.xpm

F 220,100,0
C 225,30,0

           1111111111111111111111111
           1000000000110000000000001
           1011000001110000000000001
           1001000000000000000000011
111111111111000001110000000000001
100000000011000001110111101111111
11110111111111011100000010001
11110111111111011101010010001
11000000110101011100000010001
10000000000000001100000000001
10000000000000001101010000001
11000001110101011111010000N01
11110111 1110101 101111000001
11111111 1111111 111111111111
